Carte2
Z:\Mes documents\2ème année\INFO02\TileMapping\TP_TileMapping\src\TileMapping\images\tileSetMinecraft32x32.png
15 20 32 32
165 165 165 165 70 70 70 70 70 12 12 12 12 12 12 
70 70 165 165 70 70 70 70 70 12 12 12 12 12 12 
70 70 165 165 70 70 70 70 70 12 12 12 12 12 12 
70 70 165 165 165 165 165 165 165 70 70 70 70 12 12 
70 70 165 165 165 165 165 165 165 70 70 70 70 70 70 
70 9 70 70 70 70 165 165 165 165 165 165 165 165 165 
70 70 70 70 70 70 70 165 165 165 165 165 165 165 165 
165 165 165 165 165 165 165 165 165 70 70 70 70 165 165 
165 165 165 165 165 165 165 165 165 70 70 70 70 165 165 
165 165 70 70 70 70 70 70 70 70 9 70 70 165 165 
165 165 165 70 70 70 70 70 70 70 70 70 70 165 165 
70 165 165 165 165 165 165 165 165 165 165 165 165 165 165 
70 165 165 165 165 165 165 165 165 165 165 165 165 165 165 
70 70 70 70 70 70 70 70 9 70 165 165 70 9 70 
70 70 70 9 70 70 70 70 70 165 165 165 70 70 70 
70 9 70 70 70 165 165 165 165 165 165 165 70 70 70 
70 70 70 70 70 165 165 165 165 165 165 70 70 70 9 
70 70 70 70 70 165 165 165 70 70 70 70 70 70 70 
9 70 70 9 70 165 165 165 165 165 165 165 165 165 165 
70 70 70 70 70 70 70 165 165 165 165 165 165 165 165 
