Carte3
Z:\Mes documents\2ème année\INFO02\TileMapping\TP_TileMapping\src\TileMapping\images\tileSetMinecraft32x32.png
20 15 32 32
3 3 3 18 18 18 18 18 18 18 18 18 18 18 18 18 18 18 67 67 
3 3 3 3 3 18 18 18 18 18 18 18 18 18 18 18 18 18 67 67 
18 18 3 3 3 3 18 18 18 18 18 18 18 18 18 18 18 18 67 67 
67 67 67 67 3 3 18 18 18 18 18 18 3 3 3 3 3 3 3 67 
67 67 67 67 3 3 3 18 18 18 18 18 3 3 3 3 3 3 3 67 
67 67 67 67 3 3 3 3 18 18 18 18 3 3 18 18 18 3 3 67 
67 67 67 67 67 67 3 3 18 18 18 18 3 3 18 18 18 3 3 67 
67 67 67 67 67 67 3 3 18 18 18 18 3 3 18 18 18 3 3 67 
67 67 67 67 67 3 3 3 66 66 66 66 3 3 18 18 18 3 3 3 
3 3 3 3 3 3 3 3 66 66 66 66 3 3 18 18 18 3 3 3 
3 3 3 3 3 3 3 66 66 66 66 66 3 3 18 18 18 18 18 18 
3 3 67 67 67 67 67 67 67 67 67 67 3 3 67 67 67 18 18 18 
3 3 3 3 3 3 3 3 3 3 3 3 3 3 3 67 67 18 18 18 
3 3 3 3 3 3 3 3 3 3 3 3 3 3 3 3 3 3 3 3 
67 67 67 67 67 67 67 67 67 67 67 67 67 3 3 3 3 3 3 3 
