36 36 36 36 36 70 70 70 70 70 70 70 70 70 70 70 70 70 70 70 
36 36 36 36 36 70 70 70 70 70 70 70 70 70 70 70 70 70 70 70 
70 70 70 36 36 70 70 70 70 70 70 70 70 70 70 70 70 70 70 70 
70 70 70 36 36 70 70 70 70 70 70 70 70 70 70 70 70 70 70 70 
70 70 70 36 36 36 36 36 36 36 70 70 70 70 70 70 70 70 70 70 
70 70 70 36 36 36 36 36 36 36 70 70 70 70 70 70 70 70 70 70 
70 70 70 70 70 70 70 70 36 36 70 70 70 70 70 70 70 70 70 70 
70 70 70 70 36 36 36 36 36 36 70 70 70 70 70 70 70 70 70 70 
70 70 70 70 36 36 36 36 36 36 70 36 36 36 36 36 36 70 70 70 
70 70 70 70 36 36 70 70 70 70 70 36 36 36 36 36 36 70 70 70 
70 70 70 70 36 36 36 36 36 36 36 36 36 70 70 36 36 70 70 70 
70 70 70 70 36 36 36 36 36 36 36 36 36 70 70 36 36 70 70 70 
70 70 70 70 70 70 70 70 70 70 70 70 70 70 70 36 36 70 70 70 
70 70 70 70 70 70 70 70 70 70 70 70 70 70 70 36 36 36 36 36 
70 70 70 70 70 70 70 70 70 70 70 70 70 70 70 36 36 36 36 36 
